WWWWWWWWWWWWWWWWWWWWWWWWWWWWWWWW
WWWWWWWWWWWWWWWWWWWWWWWWWWWWWWWW
WWWWWWWWWWWWWWWWWWWWWWWWWWWWWWWW
WSSSSSSSSSSSSSSSSSSSSSSSSSSSSSSW
WSOOOOOOOOOOOOOOOOOOOOOOOOOOOOSW
WSOOOOOOOOOOOOOOOOOOOOOOOOOOOOSW
WSOOOOOOOOOOOOOOOOOOOOOOOOOOOOSW
WSOOOOWWWWWOOOOOOOOOOOOOOOOOOOSW
WSOOOOWWWWWOOOOOOOOOOOOOOOOOOOSW
WSOOOOWWWWWOOOOOOOOOOOOOOOOOOOSW
WSOOOOWWWWWOOOOOOOOOOOOOOOOOOOSW
WSOOOOOOOOOOOOOOOOOOOOOOOOOOOOSW
WSOOOOOOOOOOOOOOOOOOOOOOOOOOOOSW
WSOOOOOOOOOOOOOOOOOOOOWWWWOOOOSW
WSOOOOOOOOOOOOOOOOOOOOWWWWOOOOSW
WSOOOOOOOOOOOOOOOOOOOOWWWWOOOOSW
WSOOOOOOOOOOOOOOOOOOOOWWWWOOOOSW
WSOOOOOOOOOOOOOOOOOOOOWWWWOOOOSW
WSOOOOOOOOOOOWWWWWWWWWWWWWOOOOSW
WSOOOOOOOOOOOWWWWWWWWWWWWWOOOOSW
WSOOOOOOOOOOOOOOOOOOOOOOOOOOOOSW
WSOOOOOOOOOOOOOOOOOOOOOOOOOOOOSW
WSSSSSSSSSSSSSSSSSSSSSSSSSSSSSSW
WWWWWWWWWWWWWWWWWWWWWWWWWWWWWWWW