WWWWWWWWWWWWWWWWWWWWWWWWWWWWWWWW
WWWWWWWWWWWWWWWWWWWWWWWWWWWWWWWW
WWWWWWWWWWWWWWWWWWWWWWWWWWWWWWWW
WSSSSSSSSSSSSSSSSSSSSSSSSSSSSSSW
WSFFFFFFFFFFFFFFFFFFFFFFFFFFFFSW
WSFFFFFFFFFFFFFFFFFFFFFFFFFFFFSW
WSFFFFFFFFFFFFFFFFFFFFFFFFFFFFSW
WSFFFFWWWWWFFFFFFFFFFFFFFFFFFFSW
WSFFFFWWWWWFFFFFFFFFFFFFFFFFFFSW
WSFFFFWWWWWFFFFFFFFFFFFFFFFFFFSW
WSFFFFWWWWWFFFFFFFFFFFFFFFFFFFSW
WSFFFFFFFFFFFFFFFFFFFFFFFFFFFFSW
WSFFFFFFFFFFFFFFFFFFFFFFFFFFFFSW
WSFFFFFFFFFFFFFFFFFFFFWWWWFFFFSW
WSFFFFFFFFFFFFFFFFFFFFWWWWFFFFSW
WSFFFFFFFFFFFFFFFFFFFFWWWWFFFFSW
WSFFFFFFFFFFFFFFFFFFFFWWWWFFFFSW
WSFFFFFFFFFFFFFFFFFFFFWWWWFFFFSW
WSFFFFFFFFFFFWWWWWWWWWWWWWFFFFSW
WSFFFFFFFFFFFWWWWWWWWWWWWWFFFFSW
WSFFFFFFFFFFFFFFFFFFFFFFFFFFFFSW
WSFFFFFFFFFFFFFFFFFFFFFFFFFFFFSW
WSSSSSSSSSSSSSSSSSSSSSSSSSSSSSSW
WWWWWWWWWWWWWWWWWWWWWWWWWWWWWWWW